youth	青少年时期；青春，青年人
chemical	化学品，化学制品；化学的，与化学有关的;化学品；化学物质n.【C］；adj. 化学的
Ability	能力；才能
Abilities	能力的复数形式
Able	能够，有能力的（形容词）
Enable	使。。。能够；使。。。有能力
About	大约；到处；（副词）关于（介词）
Above	在。。。上面（介词）
Abroad	到（在）国外（副词）
Accept	接受
Accident	事故，意外的事
Accurate	准确的，相当于correct and true
inaccurate	不准确的；错误的
Ache	疼；痛（可数）（动词）
Achieve	达到，获得（vt），相当于get/gain
Across	横过，穿过（介词）
Act	表演，扮演（角色）；行动（vi）
Active	积极的；活跃的；相当于be always ready to do something
Activity	活动
Actor	男演员
Actress	女演员
Act out	把。。。表演出来
activities	复数活动
actresses	女演员（复数）
actually	实际上；现实地（副词）
actual	实际的；真实的
add	添加，增加（vt）
addition	增加（不可数）
add to	加上
in addition to	除。。。以外，相当于besides/what’s more)
address	地址（可数）
addresses	复数地址
advantage	有利条件；优势；优点（可数）
disadvantage	不利条件；劣势；缺点（反义词）；不利，劣势，短处
adventure	冒险；冒险经历；冒险精神（可数/不可数）；（vt，vi）冒险
advertisement	广告（可数）
advice	忠告，劝告，建议（不可数）
advise	建议；劝告，忠告（vi，vt）
affect	影响；使感染（vi，vt）
afford	负担得起，抽得出（时间）（vi，vt）
afraid	害怕的，担心的
after	在。。。之后；在。。。后面（介词）在后；后来（副词），在。。。以后（连词）
afternoon	下午（可数不可数）
again	又，再；再一次（副词）
again and again	一再
against	对着；反对（介词）
age	年龄；时代（可数不可数）
aged	上年龄的
ago	以前（副词）
a long time ago	很久以前
agree	同意；应允（vt，vi）have the same opinion as sb.同义词
disagree	不同意
ahead	在前，向前（副词）
aim	目的；目标（可数）打算；瞄准（vt，vi）
air	空气；大气（不可数）
by air	乘飞机
by plane	乘飞机
airline	航线（可数）
airport	［C］机场
alarm	［C］ 警报
fire alarm	火警
alive	活着的，存在的;活着的
live	居住；生活；活着
life	生命；生活；人生（pl.lives）
living	活的；活着的;活的
all	全（部）；总；整（形容词）；全部地（副词）;全部；全体人员
allow	允许，准许
almost	几乎，差不多，相当于 nearly/not quite。
alone	单独的，单独地
along	沿着；顺着（介词）；向前；和••••一起；一同（副词）
already	已经（副词）
also	也， 相当于 in addition/too（不与否定动词连用）。
although	虽然，尽管，相当于 though，用于让步状语从句，不可与but 连用，但可与 yet和still 连用。although较正式，多位于句首。
altogether	总共；全部地；相当于 in all。
always	总是；一直；永远
amazing	令人惊讶的；令人赞叹的
ambition	［U,C］ 雄心；野心；相当于（strong）wish。
among	在•⋯•••中间；在三者（或三者以上）之中
amount	［C］ 数量，总数
amusement	［U,C］ 娱乐；消遣；娱乐活动
ancient	古代的，古老的，相当于 very old。
angrily	生气地；愤怒地
angry	生气的；愤怒的
animal	［C］动物
another	再一；另一；别的；
answer	［C］回答；答复；答案；回（信）vt.& vi.回答；答复；回（信）
apologize	道歉，它相当于 say sorry to sb. for sth.
appear	出现
disappear	消失，不见
apple	［C］ 苹果
apply	申请；应用
area	［C］ 面积；范围；地区
argue	争吵，争论
arm	［C］ 手臂
army	[C] 军队 (复数. armies)
around	在周围；环绕
arrange	安排；布置
arrival	［U］到达
arrive	到达；达到
art	[U,C］艺术
artist	艺术家；画家
article	[C] 文章
as well	也；又
ask	问，询问；请求，要求
assistant	［C］助手，助理
attack	进攻，袭击
attend	出席，参加，相当于 be present/go to
attention	［U］ 注意，关心
attitude	[C]态度
attract	吸引；引起
attractive	有吸引力的
audience	［C］观众；听众
aunt	[C］ 姑；姨；伯母；舅母；婶
automatic	自动的
autumn	[U］秋天，秋季，--fall同义词
available	可用的；可得到的
average	平均的；普通的［C］平均数
avoid	避免；避开
award	［C］奖品，奖励【vt】授予
away	离开；远离
awful	可怕的
baby	[C]婴 （Lpl.］ babies）
back	回（原处）；向后(adv),[C］背后，后部；背
background	[C］ 背景
bad	坏的；有害的，不利的；（worse,worst）糟糕的，可惜的；严重的
bag	［C］ 书包；提包；袋子
bakery	[C］面包店（Epl.］ bakeries）
balance	[U］平衡
ball	[C］ 球
balloon	［C］ 气球
banana	香蕉
bank	银行
bar	酒吧
base	［C］根据地，基地；基础
basic	基本的；基础的
basket	篮子
basketball	篮球
bath	洗澡
bathroom	浴室；厕所；盥洗室
battery	电池，蓄电池（［pl.］batteries)
batteries	电池（复数）
battle	战斗；战役
be	是；成为（原形，其人称和时态形式有 am,is,are, was, were, being,been）
am	第一人称
is	单数
are	复数
was	过去式单数
were	过去式复数
being	进行时；生物；人（可数）
been	完成时
beach	海滨；海滩 (Lpl. ] beaches)
bear	熊
beat	敲打；跳动；打嬴
beautiful	美丽的
beautifully	优美地
beauty	美（U）
because	因为
become	变得；成为（became, become）
bed	床
bedroom	卧室
beef	牛肉【U】
before	在••⋯以前；在••⋯前面（介词）以前（adv）在••••之前（连词）
beg	请求，乞讨(begged, begged)，相当于 ask for。
ask for	请求；寻求
begin	开始,着手(began, begun)
beginning	开始；开端【C】
behaviour	行为，举止【U】(美式 behavior)
behind	在⋯•••后面（介词）在后面；向后（adv）
believe	相信，认为
bell	钟，铃
belong	属；附属
belong to	属于
below	在•••下面（介词）
belt	（皮）带；带子（可数）
beside	在••••旁边；靠近prep.相当于 next to。
best	（good, well 的最高级）adj. & adv；最好的，最好地，最；.【U］最好的（人或物）
better	较好的，更好的；更好地(good, well）的比较级； ［U］较好的事物；较优者
between	在（两者）之间；在• 中间prep.
bicycle	自行车
bill	账单；钞票，纸币
pay the bill	支付账单
bin	箱子；垃圾箱
bird	鸟
birthday	生日
biscuit	饼干（可数）
bit	一点；一些；少量的
bite	咬；叮(bit, bitten)
black	黑色.［U,C］黑色的
blackboard	黑板［C］
board	板；木板；登，上（船、火车、飞机等）（v）
blanket	［C］ 毯子
blind	瞎的
block	一排房屋；街区（街道中间的区域）；大块 ［C］vt. 阻止
blood	血，血液［U］
blow	吹；刮风；吹气vt. & vi. （blew,blown）
blow out	吹熄；爆裂
blow off	放出；吹掉
blue	蓝色；adj. 蓝色的
on board	在船（火车、飞机）上
boat	小船；小舟vi. 划船（游玩）
by boat	乘小船
body	身体([pl. ] bodies)
boil	煮；沸腾vt. & vi.
boiled	煮沸的；煮熟的
boiling	沸腾的；激昂的
book	书；本子vt. 预订，订（房间、车票、座位等）
bookstore	书店
bookshop	书店
booking office	售票处
bored	感到乏味的；厌倦的
bore	使烦恼v.
boring	乏味的；无聊的；令人厌烦的adj.
born	（动词bear 的过去分词）出生/bom/v.
borrow	（向别人）借用；借 vt。
boss	老板；首领/bos/n. ［C］
both	（pron.两者（都）；双方（都）adj.（两）•••都；双adv. 两个都
bottle	[C] 瓶子/'botl/ n.
bottom	[C] 底部/'botam/ n.
bowl	［C］碗 n.
box	［C］ 盒子；箱子 n.（［pl. ］
boxes	盒子；箱子
boy	[C] 男孩 n.  ([pl. ] boys)
brain	脑n. [C] /brein/
brave	勇敢的adj.
bravery	勇气n.
bravely	勇敢地adv.
bread	面包/bred/ n. ［U］
break	打破（断，碎）；/breik/vt. & vi. (broke, broken)损坏；n.［C］ 休息；间隙
break down	损坏；衰弱下来
break into	闯人；破门而人
break out	爆发；突发
have a break	休息一下
take a break	休息一下
have a rest	休息一下
breakfast	[U,C]早餐
breath	呼吸，一口气；气息 n.［U, C］([pl. ]
breaths	呼吸（复数）
breathe	呼吸v.（vt. & vi.）
out of breath	喘不过气来；上气不接下气
bridge	［C］桥n.
bright	明亮的；聪明的；灿烂的adj.
bring	拿来；带来 vt. （brought, brought）
broadcast	［U,C］广播节目/bro:dkast/n.
brother	【C］兄；弟/n.
brown	褐色；棕色n. adj.褐色的；棕色的
brush	刷；擦 vi vt；n. ［C］刷子（［pl. ］ brushes）
brushes	刷子，画笔（复数）
build	建筑；建造/bild/vt.& vi.（built, built）
rebuild	重建；改造V.;重建vt（rebuilt，rebuilt）
builder	建筑工人；建立者n.
building	建筑物；大楼n.［C］
bund	外滩（the Bund） n.
burn	燃烧；着火；使烧焦 vt. & vi. （burned, burned 或 burnt，burnt）
bus	［C］ 公共汽车 n. （［pl. ］ buses）
buses	公共汽车（复数）
by bus	乘公共汽车
business	生意，事业，商业n.［U,C］
businessman	商人n.;[C] 商人 ([pl.] n.
businesswoman	女商人n.
busy	忙（碌）的adj.;忙（碌）的 adj. （busier, busiest）
businessmen	商人 [pl.]
butter	［U］黄油，奶油n.
butterfly	蝴蝶［pl. ］n.［C］
butterflies	蝴蝶［pl. ］
button	［C］ 纽扣；（电铃等的）按钮n.
buy	买 vt. （bought, bought）
by	靠近，在⋯旁边；在•••••时间； prep.不迟于；（用于被动语态）被；（表示手段、方法）用；
by train	乘/火车;乘火车
cabbage	［U,C］卷心菜 n.
cafe	咖啡馆n.
cake	［U,C］蛋糕，糕点；饼/keik/ n.
call	打电话给•；称呼；取名；呼唤；/koil/］ vt.喊；叫n.［C］喊；叫；电话；通话
calm	镇静的；沉着的adj.；vt. 使平静，安静
camera	照相机n.【C］
camp	（夏令）营；野营n.【U,C］
can	可能；能够；可以；会（助词）. v.（could）;［C］（美）罐头；罐子
could	可以，能；可能，也许；差点就，本能够（表示未发生）
cannot	不能，无法
cancel	取消vt.
capital	[C] 首都 n.
captain	船长，队长n.【C］
car	小汽车 n. ［C］
card	卡片【c】
care	［U］ 照料，保护；小心/kea（r）/n. vi. 介意；在乎；关心
look after	照顾，照料；照看，监视;照顾
careful	小心的；仔细的 adj .
look out	小心，当心;小心
carefully	小心地；仔细地 adv.
careless	粗心的adj.
carrot	胡萝卜/'keerat/ n.［U,C］
carry	拿，搬，提，抬，背，抱，携带，运送等（carried, carried） vt.
cartoon	动画片；卡通；漫画 n.［C］
case	情况；案件；箱；盒/keis/ n.［C］
cat	猫 n.[C］
catch	接住；捉住； vt. （caught, caught）赶上（车辆等）；染上（疾病）；弄清楚；领会；理解
catch a cold	着凉；伤风它相当于
get a cold	感冒。I always get a cold in the winter.
cause	原因，起因/koz/n.［C］；vt.促使，引起，使发生
cave	洞，穴；地窖n.［C］
celebrate	庆祝vt. & vi.
cent	美分 (100 cents = 1 dollar)/ sent/ n. [C]
centre	（美 center）中心，中央 n.［C］
center	中心，中央
century	世纪，百年（［pl.］n.［C］相当于 a period of 100 years。
centuries	世纪；一百年；（板球中运动员所得）一百分（century的复数）
certainly	当然，是的；一定，无疑用于回答问题时相当于 of course。/'satnl:/adv.
of course	当然，是的；一定，相当于certainly
challenge	挑战；质疑n.［C］
chance	机会n. [C]
change	改变，变化；更换；兑换（零钱）vt. &vi. n.［C］零钱；找头；变化
exchange	交换v.;交流，交换【U，C】 --change改变；零钱；找头；变化
changeable	易变的，变化无常的adj.
channel	（电视）频道n.［C］
character	性格，特性；特征，特点 n.［C］
charge	主管；掌管n.［U］；
in charge of	主管，负责
take charge of	担任；负责；照顾；承担责任并掌控某事
charity	慈善 n. ［U］
chemistry	化学n.
chicken	［U,C］ 鸡；鸡肉 n.
chief	主要的；首要的/tji:f/adj.；n.［C］领导，头（［pl.］ chiefs）
chiefs	首领（chief的复数）
childhood	［U,C］幼年时代，童年n.
chopstick	［C］，通常为［pl）筷子n.
chopsticks	筷子（chopstick的复数）;筷子n
Christmas	圣诞节n.［U,C］
on Christmas Day	在圣诞节那天
Christmas Eve	平安夜；圣诞夜
church	[C] 教堂 n.
cinema	电影院；电影 n.［C］
citizen	［C］公民；居民；市民/'sitrzn/n.
cities	城市（pl）
clerk	［C］职员；办事员 n.
clinic	［C］诊所，医务室
collect	收集，采集vt.
collection	收集n.（C）
college	［U,C］学院 n.
comfortable	舒服的adj.
comfortably	舒服地adv.
communicate	交流；交际；传达（感情、信息等）vi.
communication	通讯；交流；沟通n.
community	[C] 社区([pl.]n.
communities	社区；团体，群体；群落（community的复数）
company	［C]公司（［pl.］n.
companies	公司，企业；演出团，歌舞团；连队（company复数）
compare	比较，对照vt.
competition	［C］比赛，竞赛n.
complain	抱怨；投诉vi.
complain about	抱怨；People complain about how children spend so much time on computer games.
complaint	抱怨；投诉；不满n.
complete	完成的，完整的，完全的adj.; vt. 完成，结束
whole	相当于complete
completely	完全地，完整地adv.
computer	[C]电脑  n.
concert	［C］ 音乐会；演奏会n.
conclusion	［C］ 结论；结束，结局n.
conference	讨论会n. ［C］（正式的）会议；
confidence	自信心；信任n.【U］
confident	自信的
confidently	自信地
confuse	使困惑，扰乱；分不清 vt.
confused	（某人）（感到）迷惑的；糊涂的adj.
confusing	（某事）难以理解的；不清楚的adj.
congratulation	［C］ 祝贺n.（通常用复数形式）（［pl. ］ congratulations）
consider	考虑vt. & vi.
think about	考虑，相当于consider
consist	包含；组成，构成vi.
consist of	由•••⋯组成
contest	［C］竞赛n.
continue	继续vi.相当于go on。
continue to do something	继续做某事
continue with something	继续•
convenient	便利的；方便的adj.
convenience	便利n.
conversation	［C］会话；谈话/ konva 'setJn/n.
cough	咳嗽n. ［C］vi.
country	国家([pl. ] countries) ;/ kantri/ n. [C]农村；乡下（=countryside）
couple	［C］ 夫妇；一对；一双；一副couple 作“夫妇”解时相当于 husband and wife。
course	［C］过程；经过；课程/kos/n.
cousin	［C］堂（表）兄弟，堂（表）姐妹
discover	发现vt.;发现；看出（vt)
creative	创造性的，有创意的adj.
culture	[U, C] 文化n.
custom	［U,C］习惯，习俗n.
customer	［C］顾客，主顾/'kAstam（r）/n.
cyclist	骑（自行）车的人n.
damage	［U］ &vt. 破坏，损害
danger	[U] 危险
dangerous	危险的adj.
in danger	处于危险中
out of date	过时
daughter	［C］ 女儿
debate	争论，辩论；讨论vt.， vi. & n.［C］
decide	决定；下决心vt. 相当于 make up one's mind。
decision	决定；决心n.
decorate	装饰vt.
degree	［C］程度；度数；学位
delicious	美味的，可口的adj.
deliver	投递（信件，邮包等）；传送
dentist	［C］牙科医生/'dentist/n.
departure	［U］离开n。
depend	依靠，依赖；取决于/di'pend/v.
depend on	依靠，依赖它相当于 rely on。
describe	描写，叙述vt.
deserve	应得，应受vt.
desire	［U,C］愿望；欲望n.;vt. 渴望；热切希望
destroy	破坏，毁坏vt.
detective	侦探的 adj.;n.［C］ 侦探
develop	发展；开发；培养vi.
development	发展n.
dialogue	（美 dialog）n. ［C］ 对话
diary	［C］日记；日记薄
diaries	复数日记
dictionary	［C］词典，字典
dictionaries	复数字典
difference	[U,C] 不同
different	不同的，有差异的adj.
difficult	困难的；费力的adj. 相当于 hard/rough。
hard	硬的，困难的，艰苦的，费力的（adj、adv）She tried extra hard.努力地，使劲，猛烈地
rough	粗糙的，不平的；粗暴的，猛烈的；多暴力的；粗暴地（非正式）Cathy did a rough calculation.;粗糙的；不平的；风浪急的adj
difficulty	[U, C]困难
difficulties	复数困难
direction	［U,C］ 方向；趋势；用法说明n.
direct	直接的adj. ；V.指导；管理
directly	直接地adv.
director	导演n.
the disabled	残疾人；伤残者
go out of sight	消失，不见，相当于disappear
disappointed	失望的，沮丧的（形容词）
disappointing	使人失望的或扫兴的
be disappointed with	对。。。失望
disaster	灾难；灾祸【U,C】
cover	覆盖
be aware of	相当于discover，意识到
discussion	讨论，discuss的名词
talk about	讨论，相当于discuss
dishonest	不诚实的，欺骗性的
dishonesty	不诚实的行为
honesty	诚实（名词）
honest	诚实的，正直的
distance	距离【U，C】
disturb	扰乱，打扰（及物）
divide	分，划分；除（算数用语）
doctor	医生（可数）
dollar	美元
downstairs	在楼下；到楼下
come downstairs	下楼
draw	拉，拖；绘画（变形：drew，drawn）
drink	喝，饮（drank，drunk）；饮料；喝酒【U，C】
During	在。。。期间；在。。。过程中
duties	责任（复数）【U，C】
eager	渴望的，热切的【形容词】
be eager to do something	渴望做某事
early	早的，早地
earthquake	地震【C】
easily	容易地
easy	容易的，不费力的
east	东方的，东部的；东方【U】
economy	经济【U，C】
education	教育【U】
educational	教育的
effect	效果【U，C】
effective	产生预期结果的；有效的
effort	精力，努力【U，C】
either	两方任一方的；二者之一的（adj，代词）；也（不）（用于否定句或短语后）
electric	电的
electricity	电【U】形容词是electric
elementary	初级的；基本的
e-mail	电子邮件【C】；发电子邮件v
by e-mail	通过电子邮件
embarrassed	局促不安的，为难的，尴尬的，窘迫的
emergency	紧急情况；突发事件【U，C】
emergencies	紧急情况（复数）
enable	使。。。能够，使。。。有能力vt，=make。。。possible/make。。。able
enable somebody to do something	使某人能够做某事
encourage	鼓励vt
encourage somebody to do something	鼓励某人做某事
at the end of last week	在上周末（一般过去式时间状语）
by the end of last week	到上周末为止（过去完成时时间状语）
IN the end	最后（一般过去式时间状语，=at last或finally）
at last	最后=in the end或finally;最后
enemies	敌人（enemy的复数）
energy	精力；能量【U】
engine	引擎，发动机【C】-- Engineer工程师
Engineer	工程师，技师
enjoyable	使人愉快的；使人快乐的 --enjoy（动词）
enjoy doing something	喜欢做某事
enough	足够的，充分的（adj，adv）；足够；充足（代词）；足够（修饰形容词或副词时要放在他们后面）
enrich	使。。。丰富vt --rich 富有的
rich	富有的，有钱的，味浓的，重油的;富裕的，有钱的；味道浓的；重油的adj
entrance	入口；入场 -- enter（动词）进入；参加
enter	进入 --entrance入口（名词）
entertainment	娱乐；消遣；款待【U，C】
envelope	信封【C】
environment	环境【U，C】
escape	逃跑，逃脱【U，C】，v
especially	特别地，尤其【副词】
in the evening	在晚上
event	事件，大事；比赛项目【C】
everyday	每日的；日常的，相当于daily
daily	每日的，=everyday
exactly	确切地（赞同的回答）；确实如此
exam	考试，测试；检查【C】=examination；--动词：examine
examine	检查，细查；对。。。进行考试vt
excellent	极好的，优秀的
except	除。。。之外,不再有……;besides表示一种累加关系，意指“除了什么之外，还有……”
excited	兴奋的 --exciting使人兴奋的
excuse	原谅；宽恕vt；借口；辩解【C】
exhibition	展览；展览会【C】
exit	出口，通道【C】离别；退出Vi
exist	存在vi（不及物动词，一般不可以用进行时）
Expect somebody to do something	期待某人去做某事
look forward to doing something	相当于Expect，期待，预料
experience	经验，经历【U，C】
experiment	实验【C】
explore something for something	在。。。勘探。。。
fable	寓言【C】
face to face	面对面
in fact	事实上
factories	工厂的复数
fail	失败，不及格v ---failure 失败（名词）
fair	公平的，合理的；金色的；集市n --fairness 公平（名词）
unfair	不公平的，不公正的，反义词：fair;不公正的，不公平的；违反规则或准则的adj
fall	落下，降落；倒下；跌倒（fell，fallen）vi；秋季【C】=autumn
familiar	熟悉的
something is familiar to somebody	对。。。熟悉
somebody is familiar with something	对。。。熟悉
families	家庭，家族，家人的复数
well-Known	著名的，相当于famous
be famous for	以。。。而著名=be Known as
be Known as	以。。。而著名=be famous for
far	远的（farther，farthest或further，furthest）远地adv
far away from	离。。。远
fare	票价；费用【C】the money a passenger on public transportation has to pay.
farm	农场，农庄【C】--farmer
farmer	农民；农夫【C】
fashion	时尚
fast	快速的；迅速地；--fasten系；扎
fasten	系；扎 --反义词unfasten
favour	恩惠；好意；帮助（美favor）
do somebody a favour	帮助某人（=help somebody、give somebody a hand）
give somebody a hand	帮助某人
favourite	最喜爱的；特别喜欢的人或物（美favorite）
feed	喂养；饲养（fed，fed）
feel	感觉，觉得；触摸（felt，felt）
female	女的，雌性的;女性的，雌的adj；女性n
fence	栅栏，围栏，篱笆【C】
ferry	渡船【C】
festival	节日【C】
fever	发烧；发热【C】
have a high fever	发高烧
field	田地；牧场；场地【C】
fight	打仗；打架；争论（fought，fought）
figure	体型，外形；数字【C】
be filled with	充满着，洋溢着，=be full of
be full of	充满着 = be filled with
film	电影；影片；胶卷【C】
final	最后的，终极的 --finally 最后adv
finally	最后，最终，=at last，in the end
find	找到，发现，发觉（found，found）相当于discover
fire at the enemy	向敌人开火
fireman	消防队员【C】--firemen
firemen	消防队员的复数
firework	焰火
at first	起初，最初
fish	鱼【C】（复数：fish或fishes）鱼肉【U】；钓鱼，捕鱼vi vt
go fishing	去钓鱼
fisherman	渔夫，渔民【C】（复数：fishermen）
fishermen	渔夫（复数）
fit	使适合，与。。。相配（fit，fit或fitted，fitted）；健康的，适合的
flash	闪光；转瞬间【C】
flat	一套房间；公寓【C】
flexible	能适应新情况的；灵活的；可变动的；柔韧的；有弹性的
flexible pipe	软管
flexible plastic	软塑料
flight	航班；飞行【C】 --fly飞行v
flood	洪水，水灾
flu	流感【U】
fly	飞行；乘飞机旅行；旗帜等飘动vi；放（风筝等）vt（flew，flown）；飞行；苍蝇（复数：flies）
focus	集中
follow	听从；跟随=come、go after；仿效；跟得上
following	下列的，接着的，以下的
be fond of	爱好（=be keen on、be interested in）
be keen on	爱好
be interested in	爱好
fool	傻子【C】愚弄，欺骗vt  --foolish 愚蠢的
foolish	愚蠢的，傻的
foot	足，脚；英尺（复数：feet）
feet	足，脚；英尺的复数
football	足球（英式）；橄榄球（美式）
be bad for	有害于
be late for	。。。迟到
be ready for	为。。。做准备;准备好做= get ready for
be responsible for	对。。。负责任;对。。。负责 == be in charge of
care for	照顾；喜欢
for free	免费
for the first time	第一次
for the time being	暂时，眼下;暂时；眼下
get ready for	为。。。做准备=prepare for
go for a swim	去游泳
go in for	参加；从事于；酷爱I’ve never gone in for spending all day at the beach.
leave for	动身去
look for	寻找
pay for	付。。。钱，买
search for	搜寻；搜查;搜寻
stand for	代表
take a message for somebody	给某人捎个口信;给某人带口信
forecast	预告，预报【C】，vt
foreign	外国的adj --foreigner
foreigner	外国人
forest	森林【U，C】
forget	忘记；忘掉（forgot，forgotten）vt
forgetful	健忘的  --forget
forgive	原谅；宽恕（forgave，forgiven）vi，vt
forgive somebody for doing something	原谅某人（做了）某事
forgive oneself	原谅自己
forward	向前，前进；今后adv
look forward to	期待着（后跟名词、名词词组或代词it）;期待
fountain	喷泉【C】
free	自由的，空闲的；免费的 --freedom
freedom	自由【U，C】 --free adj
freeze	结冰vi vt （froze，frozen）
frozen	冰冻的
freezing	结冰的；极冷的，相当于very cold
fresh	新鲜的
fried	油煎的
friend	朋友 --friendly
friendly	朋友般的，友好的
friendship	友谊
frighten	使害怕vt
frightened	受惊吓的；吃惊的adj
frightening	恐怖的adj
be different from	与。。。不同
come from	出生于；来自
from time to time	不时；有时;不时，偶尔
hear from	收到。。。来信
keep from	阻止；使。。。免于
learn from	向。。。学习
prevent from	阻止。。。做
protect from	保护。。。免受
tell from	区别；分辨
fuel	燃料
full	满的，充满的，完全的
fun	乐趣；有趣的事；娱乐；玩笑【U】---funny
funny	滑稽的，可笑的 --fun
furniture	家居总称【U】
further	较远，更远；进一步；而且adj；促进，增进v；更多的adj
gain	获得，达到=get、achieve
the Olympic Games	奥运会
general	大体的，笼统的，总的
generation	一代【C】
generous	慷慨的；大方的
gentle	温柔的，轻轻的adj --gently
gently	轻柔地adv
gentleman	绅士；先生【C】复数：gentlemen
gentlemen	绅士（复数）
geography	地理【U】
get	得到vt=receive、gain；成为，变得，到达vi具有（have got短语中）
get along with	进展；与。。。和睦相处;进展；与。。相处 == get on with
get on with	进展；与。。。和睦相处
get angry	生气
get into the habit of	养成。。。的习惯
get off	下车
get on	上车
get rid of	摆脱
get tired of	对。。。感到厌倦
get to	到达=reach、arrive at/in
get up	起床
gift	赠品；礼物【C】=present
give	给；付出；给予=offer、provide、supply
give out	分发
do somebody a favor	帮助某人
give up doing something	放弃做某事=stop doing
give somebody something	给某人某物=give something to somebody
be glad to do something	乐意做某事
glass	玻璃杯【C】玻璃【U】glasses眼镜
go	去，走，到达（went，gone）
go abroad	出国
go ahead	先走；向前走；去吧；干吧
go home	回家
go on a diet	节食
go on with something	继续做某事;继续做某事 == go on doing something
go on doing something	继续做某事
go to the cinema	去看电影
go over	复习=review
go wrong	出错;出错 == make mistakes
attend school	上学=go to school
go out	外出；熄灭
go bad	变质
goal	目标【C】
golden	金色的
good	好（better，best）
be good at	擅长于=do well in
do well in	擅长于 --be poor at
be poor at	不擅长
be good for	对。。。有益 --be bad for，be harmful to，do harm to
be harmful to	对。。。有害
do harm to	对。。。有害
have a good time	玩得愉快=enjoy oneself;过得愉快 == enjoy oneself
government	政府【C】
graduate	毕业vi；大学毕业生【C】
a bunch of grapes	一串葡萄
greenhouse	温室，暖房【C】
greet	问候，向。。。致敬vt
grow	生长，发育；种植；变成（grew，grown）
grow up	长大成人，成长
guide	向导，导游；指南
guitar	吉他【C】
half	一半，半个，复数：halves；一半的
halves	一半的复数
hamburger	汉堡包
hand somebody something	递给某人某物
hand something to somebody	将某物递给某人
hang	处绞刑；上吊（hanged，hanged）；悬挂，把。。。吊起（hung，hung）
happen	发生，碰巧vi
happily	幸福地；快乐地
happy	幸福的，高兴的
unhappy	不开心的，难过的;不开心的，不幸福的，难过的adj
happiness	幸福，快乐【U】
hardly	几乎不adv
harm	伤害v，n ---harmful
harmful	有害的，能造成损失的
hate to do something	讨厌做某事
hate doing something	讨厌做某事
have a headache	头疼
headline	大字标题（报刊的）【C】
headmaster	中小学校长【C】
health	健康【U】
healthy	健康的
unhealthy	不健康的;不健康的adj
hear	听见；听说；得知（heard，heard）
receive a letter from somebody	收到某人的来信=hear from sb
heat	热度，热量【U】加热v --hot
heavy	重的 --heavily沉重地；大量地adv
height	高度 --high高的
of average height	中等高度
help	帮助n vt --helpful
helpful	有帮助的，有益的
helpless	无助的
help somebody to do something	帮助某人做某事，to可以省略
help somebody with something	帮助某人做某事
heroes	英雄的复数
hesitate	犹豫，踌躇vi
hide	隐藏（hid，hidden）
historical	历史的，历史上的
history	历史，历史学
a historical figure	历史人物
a history teacher	历史老师
hold	拿；抱；握住；举行；保持；容纳（held，held）
hold on	等一等（别挂电话）
hold a meeting	举行会议
hold one's breath	屏住呼吸
hole	洞，坑 --同音异义词whole
on holiday	在休假
summer holidays	暑假
homeless	无家可归的
at home	在家
in one's home	在某人家
come home	回家
on one's way home	在某人回家路上
a homeless dog	流浪狗
hometown	家乡，故乡【U】
do one's homework	做家庭作业
an honest student	一个诚实的学生
Honeymoon	蜜月
honour	荣誉，光荣【U】（美honor）
in honour of	向。。。表示敬意；为纪念。。。
hopeful	满怀希望的，给人以希望的
hopeless	没有希望的
horrible	令人恐惧的；恐怖的
in hospital	住院（生病）
in the hospital	在医院里（工作或看护）
go to hospital	去医院看病
go to the hospital	去医院（不是看病）
hostess	女主人，女节目主持人  ---host
hot	热的，辣的（hotter，hottest）
in the hotel	在宾馆
half an hour	半小时
houses	房子，住宅，家的复数
housewife	家庭主妇
in the house	在房子里
housework	家务活
do housework	做家务
hug	拥抱vi vt（hugged，hugged）
a huge amount of	巨量的（跟不可数名词！！！）
humans	人类【C】的复数
humorous	幽默的，风趣的 --humour幽默n
humour	幽默n
hungrily	饥饿地 --hungry 饥饿的
hunt	寻找；猎取 vi vt  --hunter猎人
go hunting	打猎
in a hurry	匆忙地
hurry to someplace	匆忙去某地
hurry up	快点
hurry off	匆忙离开=leave in a hurry
break the ice	打破僵局，使气氛轻松
come up with an idea	想出一个办法=think of an idea
ill	有病的，不健康的
illness	疾病n
become ill	生病
fall ill	生病
get ill	生病
feel sick	感到恶心，感到难受=feel ill
illnesses	疾病的复数
immediately	立即，马上=at once、right away、in no time
in no time	立即马上
important	重要的adj
importance	重要性【U】
impossible	不可能的 --反义：possible;不可能的adj
impression	印象【C】
improve	改进，更新vi vt（improved）
include	包含，包括vt --including
including	包括 prep
income	收入，所得【U，C】
increase	增加n vt vi
independent	独立的，有主见的adj --反义：dependent依靠的，依赖的
industries	工业产业的复数
influence on	对。。。影响
influence in	干涉，介入
under the influence of	在。。。的影响之下
social influence	社会影响
instead of	代替，=in place of
instruction	指令，命令，指示，教导；用法说明【C】
interest	兴趣，趣味 n
interested	感兴趣的
interesting	有趣的，有意思的
international	国际的;国际的adj
interview	采访，会见，面试【C】 vi vt
introduce	介绍vt
introduction	介绍n
invent	发明，创造vt --invention发明n
inventor	发明家【C】 --invent
investigate	调查vt
invitation	邀请，请帖【C】--invite动词vt
island	岛【C】
traffic jams	交通堵塞;交通堵塞 ，也可以是 traffic jam
a pair of jeans	一条牛仔裤
play a joke on somebody	开某人的玩笑
joke with somebody	和某人开玩笑
journalist	记者，新闻工作者【C】
journey	旅行，旅程【C】
make on a journey	去旅行=go on a journey
judge	裁判；审判员；法官n；审判；断定vt
just now	刚才（常用过去式）;刚才
just then	就在那时
keen	热心的
be keen on something	热衷于某事
be keen on doing something	热衷于做某事
keep	保持；保存，继续不断；培养，饲养（kept）
keep something adjective	使某物保持某种状态（+形容词）
keep doing something	继续做某事
keep a dog	养一只狗=raise a dog
kid	开玩笑vi（kidded）；小孩【C】
kilogram	千克，公斤【C】=kilo
kilometre	千米（美kilometer）【C】
kindness	仁慈，好意 --kind善良的，友好的
unkind	不友善的
be kind to	对。。。友好的
kindergarten	幼儿园【C】
kitchen	厨房【C】
knives	小刀的复数
knock	敲门，打，击【U】vi
Knock at the door	敲门
know	了解；知道；认识；懂得vi vt（knew，known）
knowledge	知识，学问【U】--know动词
laboratory	实验室【C】=lab
in the lab	在实验室里
ladies	女士的复数
Ladies and gentlemen	女士们，先生们
in the lake	在湖中
on the lake	在湖面上
lantern	灯笼【C】
laughter	笑n --》动词：laugh
laugh at somebody	嘲笑某人
lawyer	律师【C】---law法律【U，C】
lay	放，搁；下蛋（laid，laid）vt
lazy	懒惰的（lazier，laziest）
lazily	懒惰地
laziness	懒惰n
lead	领导；带领vi vt（led，led）--leader领导人
learn	学习，学会（learnt，learnt或者learned，learned）---learner学习者，初学者
leave	离开，把。。。留下；剩下vt vi（left，left）；准假【U】
lecturer	演讲者，讲师 --lecture【C】讲座，演讲
attend a lecture	参加讲座
lend	借出；把。。。借给 vt（lent，lent）-》反义词：borrow
borrow something from somebody	借进
lend somebody something	借某物给某人=lend something to somebody
length	长度【U】 --long长的
librarian	图书管理员【C】 --library图书馆，图书室
lie	谎言；说谎v，【C】（lied，lied）；躺；卧；位于vi（lay，lain）
lives	生命的复数
lift	举起vt；电梯【C】--elevator
dislike	不喜欢 --反义：like
unlike	不像
like to do	喜欢做 --like doing
like doing	喜欢做
likely	很可能的adj；很可能地adv
time limit	限期
speed limit	限速
limited	有限的，限制的adj
liquid	液体【U】
litter	废物，垃圾【U】乱丢杂物vt vi
little	小的（less，least）；很少的，稍许adv；一点，没有多少【U】
locate	坐落于；确定。。。的地方vt --location
be located	坐落于be located in/on/at=lie in/on/at
location	位置；场所【C】
look at	看（强调动作）
look up	查找，抬头看
lose	失去vt（lost，lost)
lost	丢失的，迷路的
loud	大声的---loudly大声地adv
lovely	美好的，可爱的
luck	好运【U】
lucky	幸运的
unlucky	不幸的
luckily	幸运地；侥幸地
unluckily	不幸地
luggage	行李
lunch	午餐【U】
machine	机器【C】
washing machine	洗衣机
mad	发疯的；生气的adj
go mad	发疯
be mad at somebody about something	因某事生某人的气 = be mad with somebody
magazine	杂志
magic	魔术；魔法【C】 --magic 有魔力的；有神奇力量的adj
magician	魔术师
mail	邮件；邮递（美）【U】；邮寄vt
by mail	邮寄
main	主要的adj，=most important
mainly	主要地adv
major	主要的adj；（大学中的）主修科目【C】
play a major role in	在。。。中起重要作用
make	制造；做；使得（made，made）vt
male	男性的；雄的adj；男性【C】 --反义：female
mall	大型商场=shopping mall
men	【C】成年男人；人类【复数】
manage	管理；经营=run；处理；设法对付vt；
manager	经理n
manage a company	管理一家公司
manage to do something	成功地做某事=succeed in doing something
succeed in doing something	成功地做某事
manner	方式；态度，举止【C】
in a good manner	有礼貌 --反义：in a bad manner
many	许多的adj，（more，most）；pron许多人或物
a great many	许多
map	地图【C】
mark	标记，记号；符号；分数（考试等）【C】；标明，作记号于；给。。打分数
market	市场；集市【C】
marry	（使）成婚，结婚vt，vi
married	已婚的
marriage	婚姻n
marry somebody	嫁（娶）某人
get married to somebody	嫁（娶）某人
match	比赛，竞赛；火柴【C】--复数matches；与。。匹配vt
material	材料，原料【C】
maths	（美math）=mathematics数学（通常做单数用）
matter	要紧事，麻烦事，事情；问题；物质【U，C】；要紧，有关系vi
may	可以；也许，可能（might）
maybe	可能，大概；也许adv
meal	一餐（饭）【C】
mean	意思是，意味着vi，vt（meant，meant）；刻薄的adj
meaning	意思，意义；含义n；意味深长的adj
meaningful	有意义的adj
mean to do something	故意做某事
meat	肉【U】
medical	医学的，医疗的adj
medicine	药n【U】
medical school	医学院
medical care	医疗护理
take medicine	服药
medium	中间的，中等的adj
of medium height	中等身高
meet	遇见，见到；会见；迎接；满足vt（met，met）；会，集会【U】
meeting	会议，集会【U】；会见
at the meeting	在会上
attend a meeting	参加会议
member	成员，会员【C】
memory	回忆，记忆【U，C】--复数：memories
memorize	记忆v
in memory of	纪念
mention	提到，说起vt
menu	菜单【C】
mess	混乱；杂乱【C】--复数：messes；使不整洁；弄脏；弄乱vt vi
message	消息；音信【C】
messenger	送信人；通讯员；信使 n
leave a message for somebody	给某人留言
metal	金属【U】
a piece of metal	一块金属
method	方法，办法【C】
a method of something	做某事的方法 =  of doing something
metre	米，公尺【C】（美meter）
middle	中间；当中；中部n
in the middle of	在。。中间
mile	英里【C】
mind	思想；想法【U】；介意，关心vt vi
mind doing something	介意做某事
minus	负的，减去的adj & prep
miss	失去，错过，缺；惦记vt
Miss	小姐，女士（称呼未婚妇女）
mistake	错误【C】，弄错，误解vt
mix	混合，搅拌vt --mixture混合物
mixture	混合物【U，C】
model	模型；范例；模范；模特【C】
modern	现代的
moment	片刻，瞬间 [C]
at this moment	此时
monitor	班长；监视器【C】
monkey	猴子【C】
month	月份【C】--复数：months
mood	心情，语气，气氛【C】
in a bad mood	心情坏 --反义：in a good mood
in the mood	兴致勃勃
more	（much 或 many）的比较级；较多的；更大的；更多的；再，更adj；更多的量【U】
in the morning	在早上、上午
most	（much 或 many）的最高级；最大的，最多的，大多数的，大部分的；最adv；大部分，大多数【U】
motorcycle	摩托车【C】
mountain	山脉【C】
mouse	老鼠【C】；鼠标 --复数：mice
mice	复数的老鼠；鼠标
mouths	复数：嘴，口【C】
move	移动；搬动；搬家；感动vt vi
movie	电影C
Mr	先生
Mrs	夫人，太太
much	（修饰不可能名词）许多的，大量的adj；非常；更加adv；许多；大量【U】
museum	博物馆【C】
mushroom	蘑菇【C】
music	音乐；乐曲【U]
must	必须；需要；应当；必定是；一定 v&aux
name	名字，姓名，名称【C】；命名，名叫vt
narrow	狭窄的（narrower，narrowest）--反义：wide
wide	宽的;宽的；广泛的adj（wider，widest）
nation	民族；国家【C】
national	全国性的；国家的；民族的adj
nationality	国籍n --复数：nationalities
nationalities	国籍n 【复数】
on National Day	在国庆节那天
native	本地的，本国的，当地的adj；本地人，本国人【C】
natural	自然的，天然的adj --nature自然，本质n
nature	自然，本质n【U】
by nature	本性上，生性
naughty	顽皮的（naughtier，naughtiest）
near	在。。附近prep；附近的adj；临近adv
nearby	附近的adj；在附近adv
nearly	将近；几乎；差不多adv
necessary	必须的，必要的adj
need	需要；必须【v /aux】；需求；必要【U，C】
it is necessary for somebody to do	某人有必要做。。。
it is necessary that	从句。。。是必要的
make it necessary for somebody to do	使某人必须做
meet the needs of	满足。。。的需要，needs可用单数或复数
neighbour	（美neighbor）邻居【C】
neighbourhood	（美neighborhood）临近地区，街坊【C】
neither	（两者）都不pron；adj；也不adv；conj
neither A nor B	（A或B）都不
nervous	紧张的adj
be nervous about	。。。紧张不安，担心 = be nervous at
be nervous at	。。。紧张不安，担心 = be nervous about
net	网[C]
surf the net	上网浏览
network	网络；网络系统【C】
build up a network	建立网络
create a network	建立网络
set up a network	建立网络
never	绝不；从来没有adv
never mind	没关系
news	新闻；消息【U】
a piece of news	一则新闻
news conference	记者（招待）会
newspaper	报纸【C】
read a newspaper	看报纸
in a newspaper	在报上
next	最近的；紧挨着的；隔壁的；下一次的adj；最近地，然后；下一步
next to	在。。。旁边；紧挨着
next time	下次
next year	明年
the next year	第二年
at night	在夜里
during the night	在夜间=in the night
day and night	夜以继日 = night and day
last night	昨天晚上
good night	晚安
a good night's sleep	一夜好觉
noise	声音；噪声；响声【U，C】
make a noise	弄出声
noise pollution	噪音污染
reduce the noise	减少噪音
noisy	嘈杂的；喧闹的adj（noisier，noisiest）
none	没有任何东西；没有人pron
noodle	面条（常做noodles）【C】
nor	也不
north	北的；朝北的；北方的adj；北方；背部【U】
in the north of	在。。。的北部（在内部）
on the north of	在。。。的北边（接壤）
to the north of	在。。。以北（不接壤）
in the north	在北方
nose	鼻子【C】
note	便条，笔记；钞票【C】
nothing	没有东西，没有什么pron
notice	布告；通知；注意【U，C】；注意，注意到vt=see and realize something
notice somebody doing something	注意到某人在干什么
notice somebody do something	注意到某人干了某事（强调注意到了动作进展的全过程）
novel	小说【C】
now	现在adv
now that	既然，由于，=since
now and then	偶尔，有时=again
till now	到现在为止 = up to now
up to now	到现在为止
from now on	从现在起
from then on	从那时起
right now	立刻
nowadays	当今，现在adv
nowhere	任何地方都不adv
number	数字；号码；数量【C】
nurse	护士；保育员【C】
obey	服从；顺从；听从vt
observe	观察；观测vt
occupation	职业【C】
ocean	海洋【C】
o'clock	。。。点钟adv
of	（表示所属，数量，其中等）。。。的
off	离开，走开；断掉（水、电等）；完，光adv；脱离，走开；从。。。离开prep
put off	延期
take off	脱掉；起飞
keep off	阻挡
show off	炫耀
turn off	关掉（电、水等）;关掉（电灯，电视，收音机等）
offer	提供vt；【C】
office	办公室【C】
officer	官员，办事员【C】
official	官方的，政府的，官员的adj
often	经常adv
oil	油；石油【U】
old	年老的；古老的；就的adj（older，oldest或elder，eldest）
Olympic	奥林匹克的adj；奥林匹克（运动会）【C】
once	一次，一度，从前adv，conj，n
online	在线的adj；adv
only	只；只有；仅仅adv；唯一的，仅有的adj
onto	到。。。上面
open	打开；张开；开设vt；开着的，开口的；敞开的；营业中的adj
operate	动手术，开到vi；操作，运转vt --operation手术n
operation	手术n【C】
opinion	观点，看法【C】
in one's opinion	根据某人的看法
opposite	在。。。对面；相对的；对立的adj，prep
order	命令，指示；顺序【C】；命令；订购；点（菜、饮料等）vt
order somebody to do something	命令某人做某事
ordinary	普通的，平常的adj=common、usual
organization	组织，团体，机构【C】
organize	组织vt
other	其他的，另外的adj；别人，别的东西pron
ought to	应该，应当aux = should，后跟动词原形，否定形式为ought not to
out	向外，在外；离开adv
outdoor	室外的adj
outdoor activity	室外活动
outing	远足，郊游【C】（集体）出外游玩（或学习等）
go for an outing	外出远足
oven	炉子，烤箱【C】
over	在。。上方；越过；遍及；超过prep；结束；越过；翻转adv
more than	超过 = over
all over the world	遍及全世界;遍布全世界 == throughout the world
own	自己的adj；拥有vt
owner	拥有者，物主【C】
of one's own	属于某人自己的
Pacific	太平洋n
pack	包【C】；打包【vt】
pain	疼痛【U，C】
painful	疼痛的
paint	油漆，粉刷；绘画【vt vi】；油漆；涂料【U】；颜料【C】
painting	油画，水彩画，画【C】
oil paints	油画颜料
pair	一双；一对【C】
a pair of	一双；一副
a pair of trousers	一条裤子
two pairs of shoes	两双鞋子
a pair of glasses	一副眼镜
palace	宫殿；宫【C】
the Palace Museum	故宫
the Summer Palace	颐和园
pale	苍白的，灰白的adj
panda	熊猫【C】
paper	纸【U】；报纸=newspaper【C】；考卷（常做papers）；文件
a piece of paper	一张纸
parent	父母【C】，双亲（复数）=someone's father or mother
Paris	巴黎（法国首都）
park	公园【C】停放（车辆等）【vt】
part	部分；角色；部件；零件【C】
take part in	参加
partner	搭档，合作者【C】
party	聚会，晚会；政党；党派【C】复数：parties
pass	传，递；通过vt；经过，路过vi
passage	（文章等的）一节，一段；通道【C】
passenger	乘客，旅客【C】
passport	护照【C】
past	过。。。走过某处prep；过去；昔日；往事【U】
patient	病人【C】；耐心的adj
impatient	不耐烦的adj
patience	耐心n
pay	付钱，给。。。报酬vt，vi（paid）；工资【U】
P.E.	体育（physical education的缩写）
peace	和平【U】
peaceful	和平的adj
war and peace	战争与和平
pear	梨【C】
pearl	珍珠【C】
pen friend	笔友
a picture in pencil	铅笔画
people	人们，人民（视为复数）n
per	每一prep
eighty kilometers per hour	每小时80公里
percent	百分比【C】
perfect	完美的；极好的adj=excellent
performance	表演，演出；行动【C】
perhaps	可能，也许adv = maybe
personal	个人的adj；私人的
pet	宠物【C】
phone	电话【U】；电话机【C】=telephone；打电话vt vi
hang up the phone	挂断电话
photo	照片【C】=photograph
take photos	拍照
physical	身体的；物理的adj
physics	物理（学）n
piano	钢琴【C】 --pianist 钢琴家
pianist	钢琴家
pick	拾起；摘；采集；挑选vt
pick up	拾起
pick out	挑选出
picnic	野餐【C】
go on a picnic	去野餐
picture	图片，画片，照片；影片【C】
take pictures	拍照 = take photos
piece	一块（片，张，件，段。。。）【C】；碎片；部件
a piece of	一张（片，张，件，段。。。）
pilot	飞行员【C】
pin	用针别vt（pinned）；针【C】
pineapple	菠萝【C】
pioneer	先锋；开拓者【C】
pity	怜悯；同情；可惜【U】
have a pity on somebody	怜悯某人
pizza	比萨饼【U，C】two cheese pizzas 两张芝士比萨。【C】a piece of pizza 一块比萨。【U】
place	地方；处所【C】；放置【vt】
plan	计划，打算vt（planned）；【C】
make a plan	制定计划
plane	飞机【C】
planet	行星【C】
plant	种植=grow；播种vt；植物【C】
plastic	塑料的adj
plate	盘子；碟子；板；牌【C】
platform	讲台；站台【C】
play	玩vi；打球；演奏；扮演；播放vt；玩耍【U，C】；戏剧；剧本【C】
player	运动员，选手；演奏者n【C】
play with	玩耍，摆弄
play a trick on	捉弄
playground	操场，运动场【C】
pleasant	令人愉快的，舒适的adj
pleased	高兴的adj；感到满意的
be pleased with	对。。。感到满意的=be satisfied with;对。。。满意
pleasure	高兴；愉快n【U，C】
with pleasure	愉快地
plenty	丰富，充足；大量n
plenty of	大量的，充足的
plus	加，加上prep
P.M.	下午(p.m)
pocket	（衣服的）口袋【C】
pocket money	零花钱
poem	诗【C】
poet	诗人n
point	指；指向vi；点；分数；小数点【C】
point out	指出
pole	杆；极【C】
policemen	警察【复数】
policewomen	女警【复数】
polite	有礼貌的adj
politely	有礼貌地adv
politics	政治【U，C】
pollute	污染，弄脏vt
pollution	污染n【U，C】
pool	水塘，水池【U，C]
poor	贫穷的；可怜的；不好的adj
popular	流行的；大众的；受欢迎的adj = pop
population	人口，人数【U，C】
pork	猪肉【U，C】
possible	可能的，也许的adj
possibly	可能地，也许adv = maybe、perhaps、probably
post	邮政，邮寄，邮件【U】投寄；邮寄【vt】=mail
postcard	明信片【C】
poster	海报【C】
postmen	邮递员【复数】
pot	锅；壶；罐【C】
potato	土豆，马铃薯【C】
potatoes	土豆【复数】
pound	磅（重量单位）；英镑【C】
a pound of apples	一磅苹果
a five-pound note	一张五英镑的纸币
power	电源；能源；动力；电力【u】
powerful	强大的adj
practice	练习；实践【U，C】；vt=practise
praise	赞扬，表扬【U】vt
praise somebody for something	为某事而表扬某人
precious	宝贵的，珍贵的adj
predict	预言；预料v
prefer	宁愿（选择），更喜欢vt（preferred）注意双写r
prefer...to...	喜欢。。。多于，=like better than
prefer to do A rather than do B	宁愿做A而不愿意做B
prepare	准备，预备vt
prepare for	使做好准备，把。。。预备好 = get ready for
present	礼物；赠品【C】现在（仅用单数）；出现的，出席的adj
at present	目前，现在 = now、for the time being
president	总统；主席【C】
press	压，按vt
press the button	压按钮
pretend	假装，装作vt
pretend to do something	假装做某事
pretty	漂亮的 = beautiful
prevent	预防；防止；阻止，阻挡vt
prevent somebody from doing something	阻止某人做某事 = stop somebody from doing something
price	价格【U】
primary	初等的；初级的adj
primary school	小学
print	打印，印刷vt
prison	监狱【U，C】
prisoner	犯人
put into prison	入狱
private	私人的；私有的adj = personal
prize	奖赏，奖品【C】
the first prize	一等奖
probable	很可能发生（或存在等）的；很可能的；大概的 adj
probably	很可能地，大概，或许 adv = maybe、perhaps、possibly
problem	问题，难题，习题【C】
the key to the problem	处理问题的关键
process	处理；加工vt；过程【C】
produce	生产；产生；制造vt
product	产品n【U，C】
professional	专业的，职业的adj；专业人员；职业运动员【C】 --反义：unprofessional 不专业的
professional development	专业发展
professional knowledge	专业知识
programme	（美program）节目；项目；计划；（计算机）程序【C】；编写程序；为。。。制定计划v
progress	进步，进展【U，C】
make progress	取得进步
project	工程；课程；作业；项目；规划【C】
the Channel Tunnel project	海底隧道工程
promise	答应；承诺【C】【Vi】
promise to do something	承诺做某事
pronounce	发音vt
pronunciation	发音n
properly	恰当地，合适地adv = correctly
protect	保护vi
protect...from...	保护。。免受
proud	自豪的；骄傲的adj
be proud of	为。。感到骄傲，自豪
prove	证明vt --proof证明n
proof	证明n
prove to be	证实
proverb	谚语，格言【C】 = saying
saying	谚语，格言；俗语 【C】
an old saying	一句古老的谚语
provide	提供vt
provide ...with	提供；供应；给予
public	公共的，公众的adj；公众n
be in public	在公共场合
publish	出版vt
pull	拉；拖；拔vt
purpose	目的；用途【C】
on purpose	故意，有意地
push	推vt；【C】
put	放，摆vt vi（put，put）
put...down	吧。。。放下来
put out	伸出；扑灭
put on a play	上演一部戏
put on a coat	穿件外套
put off the meeting	会议延期举行
put up a picture	举起/挂起图片
quality	质量【u】
of good quality	质量好的
quarter	四分之一；一刻钟【C】
a quarter	四分之一，一刻钟
three quarters	四分之三,三刻钟
queen	皇后，女王【C】
Question	问题【C】
quick	快的；敏捷的；迅速的adj
quickly	快地；敏捷地；迅速地adv
quiet	安静的adj
quietly	安静地
quite	安全；十分；相当adv
quiz	测验【C】
race	比赛；赛跑vt vi；赛跑【C】
radio	无线电；收音机【C】
radios	无线电【复数】
railway	（美railroad）铁路；铁道【C】
rain	雨；雨水【u】下雨vt vi
rainy	有雨的；多雨的adj
raise	举起=put up；使升高；饲养，抚养；筹钱vt
put up	举起
raise money	筹钱
raise a child	抚养孩子
raise one's voice	提高嗓音
rarely	罕有；很少；不常adv
rather	相当，颇；宁可adv
would rather do than do	宁愿做。。。也不愿做
reach	到达vt
reach someplace	相当于get to someplace/arrive at or in someplace
read	读；朗读（read，read）vt vi
ready	准备好的；乐于adj
real	真实的，确实的；真正的adj
realize	认识到；实现 vt vi = notice、know about
really	真正地；确实
reason	理由；原因【C】
for some reason	出于某种原因
give a reason	说明原因
for whatever reason	因为种种原因
receive	收到，得到vt vi ==get
recent	近来的，最近的adj
recently	最近，近来adv
recognize	辨认出；认识vt vi
record	记录；唱片【C】；录音，录制；记录（重音在后面！！）
recorder	录音机
recycle	回收利用；使再循环vt
red	红色的adj（redder，reddest）；红色【U，c】
reduce	减少；缩减vt vi
reduce to	减少到
reduce by	减少了
reference	参考【U，C】
refuse	拒绝；不愿vt vi
refuse to do	拒绝做某事
regular	规则的，经常adj
irregular	不规则的adj
relationship	关系【C】
relative	亲属【C】
relax	使放松，轻松vi
relaxed	轻松的，自在的adj
relaxing	令人轻松的
release	释放，排放；发行，发表【C，u】vt
rely	依靠vi
rely on	依靠 =depend on
remember	记得；想起 vt vi
remember doing something	记得做过的事
remember to do something	记得去做某事
remind	提醒vt == cause somebody to remember to do
remind somebody of doing something	提醒某人做某事
remind somebody to do something	提醒某人做某事
remind somebody that	提醒某人+从句
repair	修理 【U，C】vt vi == fix、mend
repeat	重复 vt vi == say or do again
reply	回答，答复【U，C】vt vi（replied）
reply to	答复
report	报道；报告；成绩单【C】报告；汇报；（新闻）报道；调查报告【vt vi】
reporter	记者【C】
republic	共和国【C】
require	需求；要求vt vi == need
require somebody to do	要求某人做某事
require doing something	需要做某事
research	调查；研究【C】
resource	资源【C】
respect	尊敬，尊重【U】 vt
response	响应；反应；作答【U，C】
responsible	负责的，有责任心的adj
responsibility	责任，职责，责任心【U】
rest	休息；剩余部分，其余的人（物）【U,C】休息，歇息vi
restaurant	饭馆；饭店【C】
result	结果；成果【U，C】
retired	退休的adj
return	归还；偿还vt==give back；回来；返回 vi == come/go back
reuse	再利用vt
review	复习；评论【U,C】 vt == go over
revision	复习 n
reward	奖励，奖赏；报酬；报答，回报【C】；奖励；奖赏；给。。。以报酬vt
rice	稻米；米饭【U】
rid	使摆脱vt（rid，rid）
ride	骑（马、自行车等）vt vi（rode，ridden）；骑车旅行【C】
rode	骑【过去式】
ridden	汽【过去分词】
right	对；正确的；恰当的；右边的adj；正确地；恰恰；向右，在右边adv；右；权利【U，C】
ring	打电话；铃声；环形物【U，C】；（钟、铃）响；摇铃；打电话【Vt vi】（rang，rung）
rang	过去式ring
rung	过去分词ring
rise	上升；上涨；起立vi（rose，risen）
rose	过去式rise；rose玫瑰花【C】
risen	过去分词rise
river	江；河【C】
road	路；道路【C】
roast	烤（肉）vt
robot	机器人【C】
rock	岩石【U，C】
rocket	火箭【C】
role	角色【C】
role play	角色表演
room	空间；地方；房间，室【U，C】
root	根；根源；起源【C】
rope	绳子【C】
round	圆的；球形的adj；环绕地；在周围adv；环绕一周，围着prep
row	一排，一行【C】
rubbish	垃圾；废物【U】
rude	无理的，粗鲁的adj
rule	规则；规定【C】；统治vt
run	跑，奔跑；经营==manage，管理vt vi（ran，run）；奔跑【C】
run away	逃跑
rush	冲，奔跑vi
sad	悲伤的adj（sadder，saddest）
sadly	悲伤地adv，忧愁地，令人遗憾地；不幸地
safe	安全的；平安的adj；保险柜【C】
safely	安全地；平安地adv
safety	安全；平安n
save	挽救；节省vt
save one's life	救命
salary	薪金，薪水【C】
salaries	【复数】薪水
sale	卖，出售【C】
on sale	打折
for sale	出售
be responsible for sales	负责销售
salt	盐【U，C】
salty	咸的adj；含盐的
salty water	盐水
same	同样的adj；同样的事pron
the same as	和。。。一样
sandwich	三明治【C】
satisfied	满足的，满意的adj
satisfying	令人满意的，令人满足的adj
be satisfied with	对。。。感到满意 == be pleased with;对。。。满意
sauce	酱汁；调味汁【U，C】
say	说，讲vt（said，said）
schedule	安排；预定；为。。。安排时间v；时间表；节目表；工作计划【C】
ahead of schedule	提前
school	学校【C】
science	科学，自然科学【U，C】
scientist	科学家n【C】
score	得分；分数【C】
screen	屏幕；荧光屏【C】
sea	海洋【C】
seafood	海鲜【U，C】
search	搜寻；搜查vi 【n】
seaside	海滨【C】
season	季节【C】
seasonal	季节的adj
seasonal changes	季节变化
seat	座位【C】
second	第二个；秒【C】；第二位的adj；其次，第二位地adv;第二
secondary	中等的；第二的adj
secondary school	中学
secret	秘密【C】
secretary	秘书n【C】
secretaries	秘书【复数】
section	部分；部门；栏目【C】
see	看见，看到；领会，理解；拜访，会见vt（saw，seen）
see somebody doing something	看见某人正在做某事
see somebody do something	看见某人做某事
seed	种子【C】
seem	似乎，好像vi
seem to	看上去好像做了某事
seldom	很少，不常adv
select	选择，挑选，选拔vt
sell	卖；销售；出售vt（sold，sold）
send	打发，派遣；送，邮寄vt（sent，sent）
senior	年长的；高年级的；高级的adj
senior school	高中
sense	感觉；意识；感官【C】
sentence	句子【C】
serious	严肃的；严重的；认真的adj
seriously	严肃地；严重地；认真地adv
serve	招待（顾客等）；为。。。服务vt == work for
service	服务；公用事业n【C】
servant	仆人n
set	释放，安置；树立（榜样）；创造（记录）vi（set，set）
settle	安家，定居；解决vi
settle down	安置
several	几个adj
shake	握（手），摇（头）；使震动vt（shook，shaken）
shall	（表示将来）将要，会；（征求意见）。。。好吗？【v】【aux】（should）
shame	遗憾的事;羞愧【C】
shape	形状；外形；样子【C】
share	分享；共同使用vt
share something with somebody	和。。。分享。。。
sheep	（绵）羊【C】 --复数：sheep
shelf	架子；搁板【C】 --复数：shelves
shelves	架子【复数】
shine	发光；照耀；使发光vi（shone，shone）
shone	发光【过去式，过去分词】
ship	轮船【C】
by ship	乘船
shirt	男衬衫【C】
shoe	鞋【C】
a pair of shoes	一双鞋
shop	店铺【C】；购物vi
go shopping	去购物
do some shopping	购物
short	短的；矮的；短缺的adj
in short supply	不充裕；短缺；紧缺
should	应当，应该，会 aux v；（做情态动词，后接动词原形）
shout	喊；高声呼喊【C】 vi
shout at	对。。。喊叫
show	给。。。看；出示；显示；告知；表明vt（showed，shown）；展示；演出；节目；展览会【C】
show around	带领。。。参观
show somebody something	给。。。看 == show something to somebody
shower	阵雨；淋浴【C】
take a shower	洗淋浴
shut	关上，封闭vt（shut，shut）
shy	害羞的adj（shyer，shyest）
shyer	害羞的【比较级】
shyest	害羞的【最高级】
sick	有病的，患病的；（想）呕吐的；恶心的adj
side	边，旁边；面，侧面【C】
inside	在。。。里面prep；在里面adv
outside	在。。。外面prep；在外面adv
sight	风景；视力【U，C】
sightseeing	游览，观光n【U，C】
sign	符号，标记【C】；签名，署名vt
signal	信号；手势n【C】
silent	静的，无声的adj
silence	寂静n
keep silent	保持安静
silk	丝绸，丝【u】
silly	傻的，愚蠢的adj（sillier，silliest） == stupid
sillier	愚蠢的【比较级】
silliest	愚蠢的【最高级】
similar	相似的，像adj
simple	简单的，简易的adj
since	从。。。以来；自从prep；从。。以来；由于，既然conj
since then	从那以后
sing	唱歌vt（sang，sung）
sang	唱歌【过去式】
sung	唱歌【过去分词】
singer	歌手n；歌唱家【C】
song	歌唱；歌曲n【C】
single	单一的，单个的；单身的adj
sir	先生；阁下【U，C】
sister	姐；妹【C】
sit	坐vi（sat，sat）
situation	形势，情况；场面【C】
size	尺寸；大小【C】
skate	溜冰vi
go skating	去溜冰
skill	技能，技巧【C】
skin	皮肤【U，C】
skirt	女裙【C】
sky	天空【U，C】
sleep	睡觉vi（slept，slept）；睡眠【U，C】
slept	睡觉【过去式，过去分词】
asleep	睡着的adj
slow	慢慢的，缓慢的adj
slowly	慢慢地，缓慢地adv
smell	闻到；嗅vt vi（smelt，smelt）；气味【U，C】
smell good	好闻
smile	微笑 vi，n
smoke	烟【U，C】；冒烟；吸烟vt
snack	小吃【C】
local snacks	地方小吃
snow	雪【U，C】；下雪vi
snowy	下雪的，多雪的adj
so	如此，这么；也，同样adv；因此，所以；为的是，以便conj
so as to	为了。。。
so...that...	如此。。以至。。。
social	社会上的；社会地位的；社交的；好社交的adj
social responsibility	社会责任
social environment	社会环境
social system	社会制度
social practice	社会实践
society	社会【C】 --social adj
soft	软的，柔和的adj
softly	温柔地adv
soft drinks	碳酸饮料
soldier	士兵；战士【C】
solution	解决方法；解答【C】
solve	解决，解答vt == work out
work out	解决 ==solve;做出；算出；制定出 == solve解答
the solution to the problem	解决问题的方法
some	一些，若干；几个；某一adj；若干，一些pron
some day	将来某一天 == someday
somebody	某人；有人pron == someone
nobody	谁也不；没人pron == no one
something	某事；某物pron
sometimes	有时adv
son	儿子【C】
soon	不久；很快；一会儿adv
as soon as	一。。。就。。。
sorry	对不起的；抱歉的；难过的adj
say sorry to somebody for something	为。。。向。。。道歉 == apologize to somebody for something
apologize to somebody for something	为。。。向。。。道歉
I am really sorry for being late	我很抱歉迟到了
sound	声音【U，C】；听起来；发出声音vt vi
sound interesting	听起来有趣
soup	汤【U，C】
south	南；南方；南部【U，C】；南方的；向南的adj
southern	南面的，南部的
space	空间，太空【U，C】
in space	在太空
spaceship	宇宙飞船【C】
spare	空闲的；多余的，剩余的adj
in one's spare time	在某人的业余时间
speak	说，讲；谈话；发言vt（spoke，spoken）
spoke	【过去式】speak
spoken	【过去分词】speak
speech	演讲，说话n【C】
special	特别的，专门的adj
give a speech	作演讲
speed	速度【C】；使加速vi
at the same speed	以相同的速度
spend	度过；花费（钱、时间等）vt
spoon	调羹【C】
sport	体育运动；锻炼【C】
spread	延伸；展开；传播；扩散；散布 vt（spread， spread）
spread your wings	张开你的翅膀
spring	春天，春季【U，C】
in spring	在春天
square	广场【C】；平方的；方形的adj
People's Square	人民广场
staff	全体职员【C】
stamp	邮票【C】
stand	站；起立vi（stood，stood）
star	恒星，星【C】
start	开始；着手；出发vt；开端，开始【C】
state	状态；情形；国家，（美国的）州【C】
station	车站；电台【C】
stay	停留，逗留，呆【C】【vi】；保持【vi】
steak	牛排【C】
steal	偷，窃取vt（stole，stolen）
stole	【过去式】steal
stolen	【过去分词】steal
steam	蒸汽；水蒸气【U，C】
step	脚步，台阶【C】走，跨步【vi】
stick	木棒，枝条【C】粘住，钉住；坚持 vi（stuck，stuck）
stuck	【过去式，过去分词】stick；被卡住的，被困住的adj
still	仍然，还adv；不动的，平静的adj
stocking	长筒袜【C】 -- 复数：stockings
stomachache	胃疼【C】
stone	石头，石料【C】
stop	停止；阻止vt；停；（停车）站【C】
stop doing something	停止做某事
stop to do something	停下来去做某事
at the bus stop	在公交车站
store	商店【C】；储藏，储存vt
a department store	百货商店
store the information	存储信息
storm	风暴，暴（风）雨（雪）【C】
story	故事，小说【C】--复数：stories
tell a story	讲个故事
straight	一直的，直的adj；一直地adv
go straight ahead	笔直地往前走
strange	奇怪的，奇特的；陌生的adj
stranger	陌生人 n
strawberry	草莓【C】复数：strawberries
street	街；街道【C】
stress	压力；紧张；强调【U，C】 --复数：stresses；加压力于；使紧张；强调 vt vi
suffer from stress	承受压力
cause stress	引起压力
deal with stress	应对压力
reduce stress	减轻压力
relieve stress	缓解压力
be under stress	承受压力
strict	严格的；严密的adj
be strict in something	对某事严格
be strict with somebody	对某人严格
strike	敲，打击，侵袭；（钟）鸣vt （struck，struck/stricken）
strong	强壮的；坚固的；强烈的；坚强的adj
strength	精力，体力
student	学生【C】
study	学习；研究vt；学习；研究；书房【C】
stupid	愚蠢的，笨的adj
style	风格；时尚；类型【U，C】
in style	流行；时髦
I like the clothes with a natural style	我喜欢民族风格的服装
subject	题目；主题；学科；主语；主体【C】
succeed	获得成功，达到目的vi
success	成功n【U，C】
successful	成功的adj
successfully	成功地adv
such	这样的，那样的adj；（泛指）人，事物pron
such as	例如
suddenly	突然地adv
sudden	突然的adj
suffer	受苦；遭受vi
suffer from	遭受
sugar	糖【U，C】
suggest	建议；提议vt
suggestion	建议；提议n【C】
suggest somebody do something	建议某人做某事
summer	夏天，夏季【U，C】
sun	太阳；阳光【C】
sunny	阳光充足的，晴朗的adj
in the sun	在阳光下
super	超级的；极好的；特级的adj == wonderful
supper	晚餐，晚饭【U，C】
support	支持；赞助【U】【vt】
suppose	猜想，假定，料想vi
sure	确信的，肯定的，有把握的adj（surer，surest）【近义词】certain 肯定的，确定的adj
surer	【比较级】sure
surest	【最高级】sure
be sure	确信
surface	表面【C】
on the surface	在表面
surprise	惊奇，诧异【U，C】；使惊奇，使诧异vt
surprised	感到惊奇的adj
surprising	令人惊奇的adj
survey	调查vt 【C】
survive	幸存，活下来；存活；生还vt vi
sweep	扫除，扫vt（swept，swept）
swept	【过去式，过去分词】sweep
sweet	甜的；可爱的adj；甜食；糖果【C】
swim	游泳vi（swam，swum）【n】
swam	【过去式】swim
swum	【过去分词】swim
go swimming	去游泳
symbol	符号；象征【C】
system	体系；系统【C】
table	桌子；表格【C】
time table	时刻表
take	拿；拿走；做；吃，服用；乘坐（车、船）；花费（时间）；拍照vt（took，taken）
talent	才能；天才【U，C】
to one's great joy	使某人非常高兴的是
talk	谈话，讲话，演讲；交谈【U，C】【vi】
tall	高的adj
tap	（自来水、煤气等的）龙头【C】
tape	磁带；录音带【C】
task	任务，工作【C】
taste	品尝，尝味vt；味道【U，C】
taxi	出租汽车【C】
tea	茶叶【U】
teach	教书，教vt vi（taught，taught）
teacher	教师n
team	队，组【C】
teamwork	合作，协作n
tear	眼泪【C】
technology	技术【U，C】
teenager	（13-19岁的）青少年，十几岁的少年【C】
telephone	打电话vt vi；电话；电话机【C】
television	电视【C】=TV
tell	告诉；讲述；吩咐vt（told，told）
tell somebody to do something	告诉某人做某事
tell somebody not to do something	告诉某人不要做某事
tell somebody about something	告诉某人（有关）某事，about可以省略
temperature	温度【U】
take one's temperature	测某人的体温
temple	庙宇，寺院【C】
tennis	网球【C】
play tennis	打网球
term	学期【C】
terrible	可怕的；糟糕的adj
terribly	非常，很adv
test	测试，考查，试验vt 【U，C】
text	文本，课本【U，C】
than	比conj
thank	感谢，致谢，道谢vt；感谢，谢意【C】
thankful	感谢的；感激的adj
that	那，那个adj，pron；引到宾语从句conj
theatre	（美theater）剧场，戏院【C】
then	当时，那时；然后，后来；那么（通常用于句首或句尾）
there	在那里，往那里；（作引导词)表"存在"adv
these	这些adj pron
thick	厚的，浓的adj ---反义：thin adj薄的；瘦的；细的
thin	薄的；瘦的；细的adj
thing	东西；事情【C】
think	想；思考；认为；考虑vt vi（thought，thought）
thought	思想，想法n【C】；【过去式，过去分词】think
thirsty	渴的adj
those	那些（that 的复数）adj pron
through	穿过，通过；从始至终prep
throughout	遍及；贯穿prep == in or into every part
throw	投，掷，扔vt（threw，thrown）
threw	【过去式】throw
thrown	【过去分词】throw
ticket	票；券【C】
tidy	整洁的，干净的adj（tidier，tidiest）
tie	领带，结【C】；（用绳，线）系，栓【vt】
tiger	老虎【C】
till	直到，直到。。。为止conj，prep；常用语口语与非正式书面语中代替until。
time	时间；时期；钟点【U】次，回【C】
in time	及时
on time	准时
at the same time	同时
at a time	一次
all the time	总是
for a long time	很长一段时间
enjoy your time	祝你玩得开心
it's time for...	是时候做。。。
it's time for somebody to do something	是某人该做某事的时候了。
tip	尖端；提示；小费，小窍门，建议【C】（建议==suggestion）
tired	疲劳的，累的adj
tiring	令人劳累的，累人的adj
be tired of	对。。。感到厌倦
title	标题，题目【C】
to	（表示接受动作的人或物）给。。。；对。。。，向。。。，到。。。【prep】
be friendly to somebody	对某人友好，友善 == be kind to somebody
the answer to the question	这个问题的答案（表示从属关系）
the key to the door	这扇门的钥匙
today	今天；现在，当前【U】【adv】
together	一起，共同adv
tomato	番茄【C】 复数：tomatoes
tomatoes	【复数】番茄
tomorrow	明天【U】【adv】
the day after tomorrow	后天
tonight	今晚，今夜【U】【adv】
too	也，还；又；太，过分；很，非常。出现在肯定句的结尾，表示"也"。否定句结尾需要表示"也"则用...either
tool	工具【C】
tooth	牙齿【C】--复数：teeth
toothache	牙痛【U，C】
top	顶部【C】，（物体的）上面；最上面的；居首位的adj
topic	题目，话题【C】
touch	触摸；接触；感动vi
tour	参观，观光，旅行【C】
tourist	游客，旅客，旅行者【C】
towards	向，朝，对于prep
tower	塔【C】
the Oriental Pearl TV Tower	东方明珠电视塔
town	城镇，城【C】
toy	玩具【C】--复数：toys
toys	【复数】toy
tradition	传统【U，C】
traditional	传统的adj
traditionally	传统地adv
traffic	交通【U】
traffic lights	红绿灯
train	火车【C】；培训，训练vt
translate	翻译vt
translation	翻译n
transport	运输，运送；输送vt；【n】
transportation	运输；交通；交通工具【U】 == transport
transportation costs	运费
travel	旅行【U】【vi】
tree	树【C】
trick	恶作剧；诡计，花招【C】
play a trick on somebody	戏耍某人
trip	旅行，旅程【C】
trouble	问题；烦恼；麻烦；困难【U，C】；使苦恼；使麻烦【vt】
in trouble	处于困境中
trousers	裤子，长裤【pl】
truck	卡车；货车n
true	真的，真实的adj
truth	真理；真相，实际情况n【U】
trust	信任，相信【U】【vt】
try	试；努力【C】；试图；努力【vt vi】
have a try	试一试
try on	试穿
try doing something	尝试做某事
try to do something	尽力做某事
try one's best to do something	尽某人最大努力做某事
turkey	火鸡【C】--复数：turkeys
turn	旋转；翻转；转弯；转变；变得【vt vi】（轮流的）顺序【C】
turn on	开，旋开（电灯，电视，收音机等）
turn down	（把音量）调低
turn up	（把音量）调高
turn into	变成
turn out	结果是；证明是
turn over	翻（车）；翻（页）；翻身
twice	两次；两倍adv
two	二，两个 num
twin	双胞胎之一【C】--复数：twins
type	类型【C】打字【Vt vi】
typist	打字员
umbrella	伞【C】
uncle	叔；伯；舅；姑夫；姨父【C】
under	在。。下面，向。。下面 adv prep
underground	地下的adj；地铁【C】== （美 subway）
by underground	乘地铁
underline	在。。。下划线；强调，使突出vt
underlined	带下划线的adj
understand	明白，懂得；理解vt（understood，understood）
understood	【过去式，过去分词】understand
unforgettable	难忘的adj
unfortunately	不幸地，遗憾地adv
uniform	制服【C】
in uniform	穿着制服的
school uniform	校服
unit	单元；单位；部件【C】
united	联合的；统一的adj
university	大学【C】 --复数：universities
at university	在上大学
go to university	去上大学
unless	如果不，除非conj（unless条件状语从句可以和if条件状语从句或祈使句，and/then/or+陈述句句型相互转换。
until	直到prep conj == till
not ... until	直到。。。才
unusual	不寻常的adj  --反义：usual 通常的，平常的adj
usually	通常；经常adv
up	向上；在上方；起来 adv；prep
upset	心烦的，难过的
upstairs	在楼上；到楼上adv
use	利用；使用；应用【U，C】；【vt】
useful	有用的；有益的adj
useless	无用的；无价值的adj
value	价值；价格；数值；价值观【U，C】给。。。估价；重视；珍惜【V】
traditional values	传统价值观
increase in value	升值 == rise/go up in value
decrease in value	贬值 == fall/go down in value
variety	种种，种类【C，U】--复数：varieties
various	各种各样的，不同的 adj
vegetable	蔬菜【C】
victory	胜利【U,C】--复数：victories
video	录像；视频【U，C】--复数：videos
view	看法，见解；风景，景色；视野【U，C】
village	村庄，乡村【C】
violin	小提琴【C】
play the violin	拉小提琴
visit	参观；访问；拜访【C】vt vi
visitor	参观者；访问者n【C】
an exchange visit	一次交流访问
pay a visit to	参观；访问
voice	嗓音【C】
volleyball	排球【C】
play volleyball	打排球
volunteer	志愿者【C】；自愿（做）；自愿提供【vt vi】
wait	等，等候【vt vi】
waiter	侍者，服务员n
waitress	女侍者，女服务员 -- 复数：waitresses
wait for	等待；等候
waitresses	【复数】waitress
wake	醒来，唤醒vt vi（woke，woken）
woke	【过去式】wake
woken	【过去分词】woken
wake up	醒来，叫醒
walk	步行；散步【C】 vi
want	要；想要；需要vt vi == would like（比want语气更委婉）
want to do something	想要做某事
want somebody to do something	想让某人做某事
war	战争【C】
warm	暖和的；热情的adj
warn	警告；告诫vt
warn somebody not to do something	警告某人不要做某事
wash	洗涤；洗vt
waste	浪费vt；浪费，废物；垃圾【U】
watch	手表；表【C】--复数：watches；观看，注视；当心【vt】
wave	波浪【C】；挥手，招手；挥动【vt vi】
in this way	这样
weak	弱的，差的，淡的adj
wealth	财产，财富【U】
wear	穿；戴vt（wore，worn）
weather	天气【U】
web	网状物，网【C】
The world Wide Web	互联网
website	网站【C】
week	星期【C】
weekday	工作日【C】
on weekdays	在工作日
weekend	周末【C】
at weekends	在周末
weigh	称。。。的重量；重 vt
weight	重量n【U】
welcome	欢迎【U】；受欢迎的adj；欢迎vt；int(即感叹词）
western	西方的adj
wet	潮湿的；多雨的adj（wetter,wettest)
what's more	而且
whether	是否
who	谁pron
whom	谁【宾格】
whose	谁的（所有格）
the whole world	全世界
why not do something	为什么不做某事（表示建议）
why don't you do something	为什么不做某事（表示建议）
how about doing something	为什么不做某事（表示建议）
what about doing something	为什么不做某事（表示建议）
widely	宽阔地；广泛地adv
widen	拓宽vt
wife	妻子【C】--复数：wives
wild	野生的，荒凉的adj
will	将，会；意愿；（提问）是否愿意；。。。好吗？；意志【C】
win	获胜；赢得vt vi（won，won）
won	【过去式，过去分词】win
winner	获胜者
win the first place	赢得第一名
windy	有风的，起风的adj --名词：wind
wine	葡萄酒【U】
wing	机翼；翅膀【C】
winter	冬天，冬季【C】
wisdom	智慧【U】
wise	明智的，聪明的adj
wish	愿望；祝愿【C】--复数：wishes；希望；想要；祝愿vt
agree with somebody	同意某人的意见
be angry with	生某人的气
be busy with something	忙于做某事  = be busy doing something
be careful with	小心
be connected to	与。。。有联系 == be connected with
be covered with	被。。。覆盖
be familiar with	对。。。熟悉；通晓 == be/get familiar to/with
be strict with	对。。。严格
communicate with	与。。。交流
compete with	与。。。竞争
deal with	处理
keep in touch with	与。。。保持联系
provide...with...	向。。。提供
shake hands with	与。。。握手
with great care	非常小心
with the help of	在。。。的帮助下
wolves	狼【复数】wolf
wonder	对。。。疑惑；想知道
wonderful	美好的，精彩的；太好了adj
wood	木头，木材;树林（复：woods）【U，C】
wooden	木质的adj
in other words	换句话说
in a word	总而言之
worker	工作者；工人
work as	从事。。。工作
worry	担心；烦恼vi；担忧【U，C】复数：worries
worry about	为。。。而担心
worth	有。。。的价值；值得。。。的adj
be worth doing something	值得做某事
would	愿意（will 的过去式）
would like to	想要（表示喜欢，愿意），很想；很愿意 == would love to
would rather	宁愿，宁可
wound	创伤，伤口【U，C】
wounded	受伤的adj
write	写；写作；写信（wrote，written）vt vi
writer	作家n
wrong	错误的；不正常的；有病的adj
year	年【C】
yellow	黄色的adj；黄色【U】
yesterday	昨天adv 【C】
the day before yesterday	前天
yet	尚，还，仍然adv
yogurt	酸奶【U】
young	年轻的adj
zero	零；零度；零点【C】
zoo	动物园【C】pl：zoos
zoos	复数zoo